NO ./textures/matrix/north.xpm
SO ./textures/matrix/south.xpm
WE ./textures/matrix/west.xpm
EA ./textures/matrix/east.xpm

F 0,255,80
C 0,230,60

1111111111111111111111111111111
1N00000100001000001000000000001
1011101011101011111011011101001
1000101000001010000010010001001
1011101111011010111110110111101
1010000000010010100000100001001
1011101110111011101110111011001
1000001010000010001010000001001
1111101011111011011011111111101
1000001010001000010010000001001
1011111011101011101011011101001
1010000010001000101010010001001
1010111110011111001011110111101
1000100000010000100000000001001
1111111111111111111111111111111
