F 139,99,58
C 171,154,137

NO textures/north
SO textures/south
WE textures/west
EA textures/east

111111
100N01
111111