NO textures/matrix/north.xpm
SO textures/matrix/south.xpm
WE textures/matrix/west.xpm
EA textures/matrix/east.xpm

F 20,20,20
C 200,200,200

11111111
100000E1
11111111
