NO textures/matrix/north.xpm
SO textures/matrix/south.xpm
WE textures/matrix/west.xpm
EA textures/matrix/east.xpm

F 18,53,25
C 153,204,255

111111111111
100000000011
100000000011
111111111111
10S000000001
111111111111
110000000001
111111111111
