NO textures/north
SO textures/south
WE textures/west
EA textures/east

F 20,20,20
C 200,200,200

11011
10001
10S01
10001
10001
10001111111
11001
10001
10001
10001
10001
10001
11111
