NO textures/north
SO textures/south
WE textures/west
EA textures/east

F 20,20,20
C 200,200,200

1111111111
1000010001
1000000001
1000000001
10000E0001
1111111111