NO textures/matrix/north.xpm
SO textures/matrix/south.xpm
WE textures/matrix/west.xpm
EA textures/matrix/east.xpm

F 20,20,20
C 200,200,200

11111111111111111111111111111111111111111111111111111111111111111111111111111
10001000100010001000100010001000100010001000100010001000100010001000100010001
10100010001000100010001000100010001000100010001000100010001000100010001000101
10001000100010001000100010001000100010001000100010001000100010001000100010001
10100010001000100010001000100010001000100010001000100010001000100010001000101
10001000100010001000100010001000100010001000100010001000100010001000100010001
10100010001000100010001000100010001000100010001000100010001000100010001000101
10001000100010001000100010001000100010001000100010001000100010001000100010001
10100010001000100010001000100010001000100010001000100010001000100010001000101
10001000100010001000100010001000100010001000100010001000100010001000100010001
10100010001000100010001000100010001000100010001000100010001000100010001000101
10001000100010001000100010001000100010001000100010001000100010001000100010001
10100010001000100010001000100010001000100010001000100010001000100010001000101
10001000100010001000100010001000100010001000100010001000100010001000100010001
10100010001000100010001000100010001000100010001000100010001000100010001000101
10001000100010001000100010001000100010001000100010001000100010001000100010001
10100010001000100010001000100010001000100010001000100010001000100010001000101
10001000100010001000100010001000100010001000100010001000100010001000100010001
10100010001000100010001000100010001000100010001000100010001000100010001000101
10001000100010001000100010001000100010001000100010001000100010001000100010001
10100010001000100010001000100010001000100010001000100010001000100010001000101
10001000100010001000100010001000100010001000100010001000100010001000100010001
10100010001000100010001000100010001000100010001000100010001000100010001000101
10001000100010001000100010001000100010001000100010001000100010001000100010001
10100010001000100010001000100010001000100010001000100010001000100010001000101
10001000100010001000100010001000100010001000100010001000100010001000100010001
10100010001000100010001000100010001000100010001000100010001000100010001000101
10001000100010001000100010001000100010001000100010001000100010001000100010001
10100010001000100010001000100010001000100010001000100010001000100010001000101
10001000100010001000100010001000100010001000100010001000100010001000100010001
10100010001000100010001000100010001000100010001000100010001000100010001000101
10001000100010001000100010001000100010001000100010001000100010001000100010001
10100010001000100010001000100010001000100010001000100010001000100010001000101
10001000100010001000100010001000100010001000100010001000100010001000100010001
10100010001000100010001000100010001000100010001000100010001000100010001000101
10001000100010001000100010001000100010001000100010001000100010001000100010001
10100010001000100010001000100010001000100010001000100010001000100010001000101
10001000100010001000100010001000100010001000100010001000100010001000100010001
10100010001000100010001000100010001000100010001000100010001000100010001000101
10001000100010001000100010001000100010001000100010001000100010001000100010001
10100010001000100010001000100010001000100010001000100010001000100010001000101
10001000100010001000100010001000100010001000100010001000100010001000100010001
10100010001000100010001000100010001000100010001000100010001000100010001000101
10001000100010001000100010001000100010001000100010001000100010001000100010001
10100010001000100010001000100010001000100010001000100010001000100010001000101
10001000100010001000100010001000100010001000100010001000100010001000100010001
10100010001000100010001000100010001000100010001000100010001000100010001000101
10001000100010001000100010001000100010001000100010001000100010001000100010001
101000100010001000100010001000100010N0100010001000100010001000100010001000101
10001000100010001000100010001000100010001000100010001000100010001000100010001
10100010001000100010001000100010001000100010001000100010001000100010001000101
10001000100010001000100010001000100010001000100010001000100010001000100010001
10100010001000100010001000100010001000100010001000100010001000100010001000101
10001000100010001000100010001000100010001000100010001000100010001000100010001
10100010001000100010001000100010001000100010001000100010001000100010001000101
10001000100010001000100010001000100010001000100010001000100010001000100010001
10100010001000100010001000100010001000100010001000100010001000100010001000101
10001000100010001000100010001000100010001000100010001000100010001000100010001
10100010001000100010001000100010001000100010001000100010001000100010001000101
10001000100010001000100010001000100010001000100010001000100010001000100010001
10100010001000100010001000100010001000100010001000100010001000100010001000101
10001000100010001000100010001000100010001000100010001000100010001000100010001
10100010001000100010001000100010001000100010001000100010001000100010001000101
10001000100010001000100010001000100010001000100010001000100010001000100010001
10100010001000100010001000100010001000100010001000100010001000100010001000101
10001000100010001000100010001000100010001000100010001000100010001000100010001
10100010001000100010001000100010001000100010001000100010001000100010001000101
10001000100010001000100010001000100010001000100010001000100010001000100010001
10100010001000100010001000100010001000100010001000100010001000100010001000101
10001000100010001000100010001000100010001000100010001000100010001000100010001
10100010001000100010001000100010001000100010001000100010001000100010001000101
10001000100010001000100010001000100010001000100010001000100010001000100010001
10100010001000100010001000100010001000100010001000100010001000100010001000101
10001000100010001000100010001000100010001000100010001000100010001000100010001
10100010001000100010001000100010001000100010001000100010001000100010001000101
10001000100010001000100010001000100010001000100010001000100010001000100010001
10100010001000100010001000100010001000100010001000100010001000100010001000101
10001000100010001000100010001000100010001000100010001000100010001000100010001
10100010001000100010001000100010001000100010001000100010001000100010001000101
10001000100010001000100010001000100010001000100010001000100010001000100010001
10100010001000100010001000100010001000100010001000100010001000100010001000101
10001000100010001000100010001000100010001000100010001000100010001000100010001
10100010001000100010001000100010001000100010001000100010001000100010001000101
10001000100010001000100010001000100010001000100010001000100010001000100010001
10100010001000100010001000100010001000100010001000100010001000100010001000101
10001000100010001000100010001000100010001000100010001000100010001000100010001
10100010001000100010001000100010001000100010001000100010001000100010001000101
10001000100010001000100010001000100010001000100010001000100010001000100010001
10100010001000100010001000100010001000100010001000100010001000100010001000101
10001000100010001000100010001000100010001000100010001000100010001000100010001
10100010001000100010001000100010001000100010001000100010001000100010001000101
10001000100010001000100010001000100010001000100010001000100010001000100010001
10100010001000100010001000100010001000100010001000100010001000100010001000101
10001000100010001000100010001000100010001000100010001000100010001000100010001
10100010001000100010001000100010001000100010001000100010001000100010001000101
10001000100010001000100010001000100010001000100010001000100010001000100010001
10100010001000100010001000100010001000100010001000100010001000100010001000101
10001000100010001000100010001000100010001000100010001000100010001000100010001
10100010001000100010001000100010001000100010001000100010001000100010001000101
10001000100010001000100010001000100010001000100010001000100010001000100010001
10100010001000100010001000100010001000100010001000100010001000100010001000101
11111111111111111111111111111111111111111111111111111111111111111111111111111